HGHTH	N
NLNLN	Y
WKWNW	N
ASASA	Y
TYTLT	N
NUNUN	Y
VLVLV	Y
AMALA	N
UGUGU	Y
PSPOP	N
CLCLC	Y
TKTYT	N
MHMHM	Y
WKWOW	N
OLOLO	Y
DKDGD	N
MNMNM	Y
LPLWL	N
MOMOM	Y
YKYTY	N
FTFTF	Y
LKLPL	N
GAGAG	Y
XPXAX	N